BPGM	Core PD map
FBXL20	Core PD map
NDUFB1	Core PD map
CACNB3	Core PD map
ATP6V0C	Core PD map
ATP6V1G2	Core PD map
LDHB	Core PD map
BCAP31	Core PD map
TUBB	Core PD map
MIR29B2	Core PD map
NUBPL	Core PD map
ADCY4	Core PD map
ITGB1	Core PD map
PPP1R1B	Core PD map
RAP1GAP2	Core PD map
NDUFV3	Core PD map
CYBB	Core PD map
ADCYAP1	Core PD map
PTMA	Core PD map
FOS	Core PD map
ERN1	Core PD map
TCIRG1	Core PD map
UQCRC1	Core PD map
SLC8A2	Core PD map
RAB7A	Core PD map
UQCRFS1P1	Core PD map
NAGLU	Core PD map
ATP5PD	Core PD map
GSR	Core PD map
MT-RNR1	Core PD map
MIDN	Core PD map
MT-TN	Core PD map
TLR9	Core PD map
CRTC2	Core PD map
PGAM4	Core PD map
MIEF2	Core PD map
CREB1	Core PD map
PSMA5	Core PD map
MRPS16	Core PD map
GATA2	Core PD map
SCO2	Core PD map
KCNJ6	Core PD map
VPS35	Core PD map
MAPK12	Core PD map
ATP13A2	Core PD map
CACNG8	Core PD map
PARK7	Core PD map
BID	Core PD map
CD200R1	Core PD map
FBXW7	Core PD map
NSMF	Core PD map
TPP1	Core PD map
TLR3	Core PD map
MIEF1	Core PD map
MAP3K5	Core PD map
LAMP2	Core PD map
HSPA1A	Core PD map
RXRA	Core PD map
HSPA6	Core PD map
VPS11	Core PD map
MAOA	Core PD map
CASP8	Core PD map
NR3C1	Core PD map
CACNA2D3	Core PD map
GSS	Core PD map
CCL20	Core PD map
NSF	Core PD map
MIR128-1	Core PD map
AMBRA1	Core PD map
MIR9-2	Core PD map
HGS	Core PD map
ERCC6	Core PD map
NTRK2	Core PD map
SYN2	Core PD map
EIF2A	Core PD map
SIK2	Core PD map
PDYN	Core PD map
UQCRQ	Core PD map
GCH1	Core PD map
LAMP1	Core PD map
KEAP1	Core PD map
ARF5	Core PD map
RB1CC1	Core PD map
MARK2	Core PD map
LMNA	Core PD map
TUBB6	Core PD map
NDUFS8	Core PD map
HTT	Core PD map
DPYSL2	Core PD map
GAPDH	Core PD map
ATP5F1D	Core PD map
DGUOK	Core PD map
AKAP9	Core PD map
NEFL	Core PD map
EGR1	Core PD map
CYBA	Core PD map
RAB29	Core PD map
SLC16A7	Core PD map
CD14	Core PD map
RRAGC	Core PD map
DNM1L	Core PD map
NFYC	Core PD map
VAMP8	Core PD map
ATP6V0A2	Core PD map
MT-ND4L	Core PD map
NDUFA8	Core PD map
MMP9	Core PD map
LRPPRC	Core PD map
ATG9B	Core PD map
MAPK14	Core PD map
DLG4	Core PD map
SIRT3	Core PD map
IDH3B	Core PD map
MAFF	Core PD map
MSTO1	Core PD map
KCNN2	Core PD map
KCNN3	Core PD map
MTPAP	Core PD map
NUP62	Core PD map
PENK	Core PD map
NDUFB10	Core PD map
CFL1	Core PD map
MT-TL2	Core PD map
GABRA1	Core PD map
DDC	Core PD map
NDUFAB1	Core PD map
MT-ND4	Core PD map
NOS2	Core PD map
HSF1	Core PD map
IFNG	Core PD map
IGF1R	Core PD map
CACNB1	Core PD map
CLPB	Core PD map
MIR7-1	Core PD map
TUBB4A	Core PD map
CAMK2D	Core PD map
TNFRSF1A	Core PD map
TAB3	Core PD map
P2RX7	Core PD map
GABPA	Core PD map
TOMM70	Core PD map
COX7C	Core PD map
GSK3A	Core PD map
XPO1	Core PD map
NQO1	Core PD map
MFN2	Core PD map
PRKACG	Core PD map
SKP2	Core PD map
ARG1	Core PD map
PPP3CA	Core PD map
MIR29B1	Core PD map
TGFB1	Core PD map
CTSF	Core PD map
ATP5MC2	Core PD map
PRKAR2B	Core PD map
SLC8A3	Core PD map
DNAJB1	Core PD map
NEDD8	Core PD map
HSPB8	Core PD map
KCNJ8	Core PD map
RAC1	Core PD map
PFKP	Core PD map
FCGR1A	Core PD map
HK1	Core PD map
ATP5PF	Core PD map
PDPK1	Core PD map
PTPN6	Core PD map
COX4I2	Core PD map
ITGAM	Core PD map
NPEPPS	Core PD map
NDUFA4	Core PD map
GABRA3	Core PD map
NDUFS5	Core PD map
CTSB	Core PD map
DYNLL1	Core PD map
ATF6	Core PD map
ST13	Core PD map
GRIN2C	Core PD map
KIF1A	Core PD map
P2RY6	Core PD map
RUBCN	Core PD map
LAMB1	Core PD map
COX5A	Core PD map
ERO1A	Core PD map
COMT	Core PD map
NDUFB3	Core PD map
ADCY1	Core PD map
TSPOAP1	Core PD map
ICAM1	Core PD map
GCLM	Core PD map
RAP1A	Core PD map
ATG3	Core PD map
IL18	Core PD map
SURF1	Core PD map
MEF2D	Core PD map
ATP5MC1	Core PD map
ERCC8	Core PD map
ATP5F1B	Core PD map
GRM5	Core PD map
CAMK2G	Core PD map
NFATC3	Core PD map
GRIN2D	Core PD map
INS	Core PD map
RIMS1	Core PD map
BAK1	Core PD map
ADCY5	Core PD map
VCAM1	Core PD map
NCF4	Core PD map
ABCB7	Core PD map
NOS3	Core PD map
TSPO	Core PD map
NGF	Core PD map
TPI1	Core PD map
PARL	Core PD map
ALDH1A1	Core PD map
PTPRC	Core PD map
NR4A2	Core PD map
FCGR3A	Core PD map
SYN3	Core PD map
AARS2	Core PD map
ITPR3	Core PD map
TMEM70	Core PD map
FOXRED1	Core PD map
MT-ND3	Core PD map
PRKCI	Core PD map
ATP5MGL	Core PD map
ATP1A1	Core PD map
BAG1	Core PD map
SNCA	Core PD map
PGM1	Core PD map
S100B	Core PD map
CD47	Core PD map
TFEC	Core PD map
RASGRP2	Core PD map
TH	Core PD map
CDK2	Core PD map
HSPA8	Core PD map
CHRM1	Core PD map
NDUFAF1	Core PD map
MARCH5	Core PD map
PPARGC1A	Core PD map
SDHA	Core PD map
PIN1	Core PD map
CSNK2B	Core PD map
SRA1	Core PD map
ROCK1	Core PD map
RPS6KA2	Core PD map
CX3CL1	Core PD map
CNR1	Core PD map
PGLS	Core PD map
SUMO1	Core PD map
PSEN2	Core PD map
NDUFB8	Core PD map
TREM2	Core PD map
MT-TS2	Core PD map
IL6	Core PD map
SYP	Core PD map
GCHFR	Core PD map
CD36	Core PD map
ATP6V1C2	Core PD map
PSEN1	Core PD map
GRIP1	Core PD map
COX15	Core PD map
ATP2A2	Core PD map
TFDP1	Core PD map
DCTN1	Core PD map
ATP2B1	Core PD map
STXBP1	Core PD map
ATPAF2	Core PD map
DDIT3	Core PD map
PMPCB	Core PD map
RAB5B	Core PD map
PLK3	Core PD map
MYD88	Core PD map
OPRD1	Core PD map
TFEB	Core PD map
UCP2	Core PD map
COX7A2	Core PD map
COX10	Core PD map
KAT2A	Core PD map
PPARA	Core PD map
PPP2CB	Core PD map
GRIN2A	Core PD map
CLPP	Core PD map
SLC1A1	Core PD map
WIPI2	Core PD map
SLC1A3	Core PD map
HMGB1	Core PD map
OPA1	Core PD map
PPP3R2	Core PD map
NDUFC2	Core PD map
NDUFA12	Core PD map
ATP6V1G1	Core PD map
SLC16A4	Core PD map
PPP2CA	Core PD map
ACTG2	Core PD map
CFLAR	Core PD map
SCO1	Core PD map
SNX32	Core PD map
MT-TF	Core PD map
SLC1A2	Core PD map
GABARAPL1	Core PD map
ATP6V0E2	Core PD map
CREBBP	Core PD map
MAPK1	Core PD map
VTI1B	Core PD map
SYK	Core PD map
CAMK2A	Core PD map
PRKAA2	Core PD map
LDHA	Core PD map
RAB8A	Core PD map
GNAQ	Core PD map
MPC1	Core PD map
IL1B	Core PD map
GAK	Core PD map
CDK5R1	Core PD map
PDIA2	Core PD map
PRKAA1	Core PD map
TIMM17B	Core PD map
CACNA2D2	Core PD map
UCHL1	Core PD map
BTRC	Core PD map
PPP1R15A	Core PD map
GNB1	Core PD map
SDHD	Core PD map
PROX1	Core PD map
FOXO3	Core PD map
CHCHD2	Core PD map
ATP5ME	Core PD map
FASTKD2	Core PD map
NDUFB7	Core PD map
VPS29	Core PD map
HSPA1L	Core PD map
AKT2	Core PD map
SNX12	Core PD map
TOMM5	Core PD map
NDUFA9	Core PD map
GRIA1	Core PD map
MRPL3	Core PD map
DRD1	Core PD map
CX3CR1	Core PD map
ATP6V0A1	Core PD map
PRKACA	Core PD map
SDHAF1	Core PD map
DNMT1	Core PD map
SNCAIP	Core PD map
CTNNB1	Core PD map
HSPA4	Core PD map
COX7A1	Core PD map
CDK1	Core PD map
VPS26B	Core PD map
CPLX1	Core PD map
SEC16A	Core PD map
ALDH3A1	Core PD map
UNC13B	Core PD map
ATP6V0E1	Core PD map
NDUFA13	Core PD map
CAPN1	Core PD map
TAB2	Core PD map
STUB1	Core PD map
ADORA2A	Core PD map
BNIP3	Core PD map
YME1L1	Core PD map
SNX3	Core PD map
SLC16A1	Core PD map
MIR367	Core PD map
TP53	Core PD map
MT-ND6	Core PD map
FBXL4	Core PD map
HSP90B1	Core PD map
DAPK1	Core PD map
NDUFS2	Core PD map
NFKB1	Core PD map
UQCRH	Core PD map
FCGR2A	Core PD map
COX6C	Core PD map
POLG	Core PD map
SGTA	Core PD map
CALM1	Core PD map
EEF2K	Core PD map
DNAJB2	Core PD map
PBX1	Core PD map
CDKN1A	Core PD map
SDHB	Core PD map
ZFYVE1	Core PD map
SIRT5	Core PD map
NDUFA1	Core PD map
PRKCD	Core PD map
PUM1	Core PD map
RYR3	Core PD map
SLC7A5	Core PD map
ACTN2	Core PD map
GDNF	Core PD map
SHANK2	Core PD map
BDNF	Core PD map
SFPQ	Core PD map
IL4	Core PD map
AKR1B1	Core PD map
SLC25A14	Core PD map
ATP6V1B1	Core PD map
LAMP3	Core PD map
SLC3A2	Core PD map
MAP2	Core PD map
YY1	Core PD map
AKR1A1	Core PD map
PRKD1	Core PD map
UBQLN4	Core PD map
IDH3G	Core PD map
TACO1	Core PD map
ADCY2	Core PD map
RHOT2	Core PD map
ADCY3	Core PD map
MT3	Core PD map
HERPUD1	Core PD map
VIM	Core PD map
ELK1	Core PD map
IGF2R	Core PD map
RAB5A	Core PD map
ESRRA	Core PD map
GABARAP	Core PD map
FKBP4	Core PD map
GSK3B	Core PD map
CTSD	Core PD map
CCL2	Core PD map
ATG14	Core PD map
NRF1	Core PD map
MT-ATP6	Core PD map
EDEM2	Core PD map
MIR133B	Core PD map
NKX6-1	Core PD map
FIS1	Core PD map
MT-TQ	Core PD map
CALR	Core PD map
LMX1B	Core PD map
CAMK4	Core PD map
BECN1	Core PD map
CD22	Core PD map
ALDH9A1	Core PD map
NDUFA5	Core PD map
SYNJ1	Core PD map
TK2	Core PD map
DNAJB9	Core PD map
DUSP1	Core PD map
PRDX4	Core PD map
MT-TL1	Core PD map
SKP1	Core PD map
BCS1L	Core PD map
MT-CO3	Core PD map
CSNK2A2	Core PD map
TIMM44	Core PD map
PFKL	Core PD map
ATG5	Core PD map
FLOT2	Core PD map
CASP1	Core PD map
AKAP1	Core PD map
SLC8A1	Core PD map
RAB10	Core PD map
IRAK4	Core PD map
VDAC1	Core PD map
NDUFV1	Core PD map
NFYA	Core PD map
PPP3CC	Core PD map
TXNRD1	Core PD map
BNIP3L	Core PD map
BCL2L11	Core PD map
CLCN7	Core PD map
SLC25A27	Core PD map
WDR45	Core PD map
CSNK2A1	Core PD map
MFF	Core PD map
MT-TV	Core PD map
HTR6	Core PD map
ALDH2	Core PD map
RAB3A	Core PD map
PGAM5	Core PD map
EPB41L1	Core PD map
MAPK3	Core PD map
CRTC1	Core PD map
UQCRFS1	Core PD map
DNM2	Core PD map
NDUFB6	Core PD map
AKAP5	Core PD map
NR1H4	Core PD map
MAOB	Core PD map
MT-TC	Core PD map
TRADD	Core PD map
BAG3	Core PD map
ABCB1	Core PD map
ATP6V0B	Core PD map
SLC6A3	Core PD map
EDEM1	Core PD map
GCLC	Core PD map
IL2	Core PD map
SOCS1	Core PD map
COX5B	Core PD map
SENP5	Core PD map
SENP3	Core PD map
BCL2L1	Core PD map
MT-TW	Core PD map
VCP	Core PD map
MAPK13	Core PD map
PTGES3	Core PD map
ATG4B	Core PD map
ATP5PB	Core PD map
GHITM	Core PD map
ATG10	Core PD map
CXCL2	Core PD map
TPPP	Core PD map
POLRMT	Core PD map
CAMKK2	Core PD map
ATP6V1C1	Core PD map
SIAH3	Core PD map
MIR30A	Core PD map
PGK1	Core PD map
SIGMAR1	Core PD map
DARS2	Core PD map
COX14	Core PD map
CACNA1C	Core PD map
NDUFS6	Core PD map
VPS13C	Core PD map
HSPA1B	Core PD map
SLC2A1	Core PD map
FBXO7	Core PD map
ENO1	Core PD map
MT-ND1	Core PD map
DERL1	Core PD map
PFKM	Core PD map
NEDD4	Core PD map
UCP3	Core PD map
RELA	Core PD map
MT-CYB	Core PD map
TRAF6	Core PD map
PINK1	Core PD map
TFE3	Core PD map
TIMM23	Core PD map
IL12B	Core PD map
NFATC1	Core PD map
HDAC6	Core PD map
GNAS	Core PD map
CACNA2D1	Core PD map
TFAM	Core PD map
NDUFA3	Core PD map
C3	Core PD map
F2	Core PD map
PTEN	Core PD map
SIRPA	Core PD map
GRIA4	Core PD map
TNF	Core PD map
CAPNS1	Core PD map
CACNG2	Core PD map
NDUFS3	Core PD map
MICU1	Core PD map
TRPC3	Core PD map
TLR4	Core PD map
CUL3	Core PD map
MT-ATP8	Core PD map
PRDX1	Core PD map
VMP1	Core PD map
TPCN2	Core PD map
XBP1	Core PD map
BOLA3	Core PD map
ARPP21	Core PD map
PYCARD	Core PD map
FBP1	Core PD map
CUL1	Core PD map
MFN1	Core PD map
ITGB2	Core PD map
RANBP9	Core PD map
MAPRE1	Core PD map
SRF	Core PD map
NDUFS1	Core PD map
TLR1	Core PD map
ATP1B1	Core PD map
VPS18	Core PD map
RHOA	Core PD map
IL1R1	Core PD map
SNX6	Core PD map
HNRNPF	Core PD map
LMX1A	Core PD map
DPP3	Core PD map
TOMM40	Core PD map
GGT1	Core PD map
SREBF1	Core PD map
GPI	Core PD map
MIR9-1	Core PD map
FOXA2	Core PD map
DNAJC6	Core PD map
IDH3A	Core PD map
RET	Core PD map
CACNA1D	Core PD map
ATP5F1A	Core PD map
PTS	Core PD map
TYROBP	Core PD map
TXNIP	Core PD map
ATAT1	Core PD map
EIF2AK2	Core PD map
MAP1LC3A	Core PD map
ATP6V0D2	Core PD map
PGD	Core PD map
RAP1GAP	Core PD map
TRAF2	Core PD map
NFE2L2	Core PD map
ZSCAN21	Core PD map
ATP5MG	Core PD map
RAC2	Core PD map
MT-TS1	Core PD map
COX6A1	Core PD map
MSR1	Core PD map
LGALS3	Core PD map
MCOLN1	Core PD map
APOE	Core PD map
BAG2	Core PD map
DYNC1H1	Core PD map
FAF1	Core PD map
HTR4	Core PD map
TFB1M	Core PD map
SCARB2	Core PD map
SUCLA2	Core PD map
ANXA2	Core PD map
CDC37	Core PD map
NLRP3	Core PD map
ATP5F1C	Core PD map
VAMP2	Core PD map
ATP5IF1	Core PD map
LONP1	Core PD map
CDK5	Core PD map
PRKACB	Core PD map
ATP5F1E	Core PD map
FLOT1	Core PD map
C1QA	Core PD map
MRPS22	Core PD map
ATP1A3	Core PD map
ACSS2	Core PD map
E2F1	Core PD map
NAPA	Core PD map
TBC1D5	Core PD map
HEXB	Core PD map
ATG12	Core PD map
NFATC2	Core PD map
TFB2M	Core PD map
MEF2C	Core PD map
CABP1	Core PD map
GRM1	Core PD map
MRTFA	Core PD map
SYN1	Core PD map
RGS6	Core PD map
GALM	Core PD map
YWHAB	Core PD map
ATP5PO	Core PD map
ADCY7	Core PD map
NDUFB4	Core PD map
CD200	Core PD map
RHOT1	Core PD map
UBQLN2	Core PD map
SIRT2	Core PD map
MMP3	Core PD map
PRKN	Core PD map
MUL1	Core PD map
BAG5	Core PD map
PPP1CA	Core PD map
SYT1	Core PD map
KCNIP3	Core PD map
BBIP1	Core PD map
FASLG	Core PD map
ATG101	Core PD map
NDUFA2	Core PD map
SLC36A1	Core PD map
SOCS3	Core PD map
NDUFS7	Core PD map
CACNG4	Core PD map
HSPA5	Core PD map
MAPK9	Core PD map
HSP90AA1	Core PD map
MT-TI	Core PD map
CHRM4	Core PD map
NTF3	Core PD map
NCF1	Core PD map
PARP1	Core PD map
CCL3	Core PD map
GSTP1	Core PD map
MITF	Core PD map
VIP	Core PD map
SYVN1	Core PD map
TRPV1	Core PD map
GRM4	Core PD map
ATG13	Core PD map
SHH	Core PD map
KLC1	Core PD map
ATP2B2	Core PD map
CCNB1	Core PD map
AHCYL1	Core PD map
RIPK1	Core PD map
PDCD6IP	Core PD map
MT-TP	Core PD map
PIK3C3	Core PD map
EMX2	Core PD map
NOTCH1	Core PD map
OPTN	Core PD map
ATP2B4	Core PD map
CHCHD4	Core PD map
GLB1	Core PD map
CSNK1A1	Core PD map
MPC2	Core PD map
SQSTM1	Core PD map
TIMM50	Core PD map
ATP6V1A	Core PD map
CACNA2D4	Core PD map
PSAP	Core PD map
ATXN3	Core PD map
ARRB2	Core PD map
POLG2	Core PD map
NDUFB11	Core PD map
CHMP2B	Core PD map
DNAJC5	Core PD map
RYR2	Core PD map
ALDOA	Core PD map
GRK5	Core PD map
UQCRC2	Core PD map
CLN3	Core PD map
AGER	Core PD map
NDUFAF3	Core PD map
PIAS4	Core PD map
NAPB	Core PD map
BAG4	Core PD map
UQCR10	Core PD map
ATF4	Core PD map
NDUFA11	Core PD map
COX7B	Core PD map
COX6B1	Core PD map
HSPB1	Core PD map
NFYB	Core PD map
ATP5MF	Core PD map
RNASE1	Core PD map
ACAD9	Core PD map
ATP2B3	Core PD map
ACTR1A	Core PD map
NDUFA7	Core PD map
MT-TT	Core PD map
GABRA2	Core PD map
NBR1	Core PD map
CYCS	Core PD map
GRIA2	Core PD map
NDUFAF4	Core PD map
MCU	Core PD map
ATP6V1E2	Core PD map
SIRT1	Core PD map
SLC8B1	Core PD map
PFKFB3	Core PD map
CADPS2	Core PD map
MIR155	Core PD map
ZKSCAN3	Core PD map
MT-ND2	Core PD map
RGS4	Core PD map
HTRA2	Core PD map
PPARG	Core PD map
RPS6KA1	Core PD map
UBB	Core PD map
GCK	Core PD map
ATG7	Core PD map
KCNJ11	Core PD map
GNAI2	Core PD map
MIR128-2	Core PD map
FCGR2B	Core PD map
EIF2AK3	Core PD map
GBA	Core PD map
NFU1	Core PD map
ADCY9	Core PD map
HEXA	Core PD map
MT-CO2	Core PD map
RPS6KA6	Core PD map
NCS1	Core PD map
MTFMT	Core PD map
EP300	Core PD map
HSPD1	Core PD map
ATP6V0D1	Core PD map
DRD3	Core PD map
CDH1	Core PD map
IL10	Core PD map
CACNG3	Core PD map
ATP6V1D	Core PD map
APP	Core PD map
PMPCA	Core PD map
TRAK1	Core PD map
MAF	Core PD map
UQCRB	Core PD map
DLG1	Core PD map
ATG16L1	Core PD map
GLRX2	Core PD map
NCF2	Core PD map
FOXO1	Core PD map
TLR2	Core PD map
BCL2	Core PD map
BACE1	Core PD map
LAG3	Core PD map
NDUFV2	Core PD map
UVRAG	Core PD map
SYT12	Core PD map
ADCY8	Core PD map
MAP3K7	Core PD map
COX6A2	Core PD map
SENP2	Core PD map
RASGRF1	Core PD map
CFL2	Core PD map
KCNN1	Core PD map
MAPK8	Core PD map
G6PD	Core PD map
BMF	Core PD map
BAX	Core PD map
NDUFB9	Core PD map
MERTK	Core PD map
NDUFAF6	Core PD map
EN1	Core PD map
GRIN2B	Core PD map
IL13	Core PD map
HIF1A	Core PD map
NDUFAF5	Core PD map
NDUFS4	Core PD map
TICAM1	Core PD map
GRIA3	Core PD map
MDM2	Core PD map
CXCL1	Core PD map
DYNLL2	Core PD map
ATP5F1EP2	Core PD map
OMA1	Core PD map
MT-ND5	Core PD map
TOMM7	Core PD map
EIF2AK4	Core PD map
AKT1	Core PD map
UBQLN1	Core PD map
HMOX1	Core PD map
ATP5MC3	Core PD map
CAMK2B	Core PD map
ZNF746	Core PD map
TOMM20	Core PD map
CASP6	Core PD map
GNAI3	Core PD map
RARS2	Core PD map
SNX2	Core PD map
PTPN5	Core PD map
CEBPB	Core PD map
RRM2B	Core PD map
VPS26A	Core PD map
COX4I1	Core PD map
AKT3	Core PD map
GLA	Core PD map
RYR1	Core PD map
MAP1B	Core PD map
RTN4	Core PD map
MT-TK	Core PD map
HSPA9	Core PD map
CRYAB	Core PD map
NDUFA10	Core PD map
GLRX	Core PD map
SLC18A2	Core PD map
GNAI1	Core PD map
PRKAG2	Core PD map
CASP3	Core PD map
SESN3	Core PD map
TXN	Core PD map
SNAP25	Core PD map
MAPK10	Core PD map
COX8A	Core PD map
ATP6V1E1	Core PD map
CDKN1B	Core PD map
TRAP1	Core PD map
GNAL	Core PD map
PIK3R4	Core PD map
NDUFB5	Core PD map
TSG101	Core PD map
COX7A2L	Core PD map
ROCK2	Core PD map
DNAJC13	Core PD map
NDUFC1	Core PD map
SPR	Core PD map
CACNB2	Core PD map
HAX1	Core PD map
NEU1	Core PD map
MT-TR	Core PD map
MT-CO1	Core PD map
OPRM1	Core PD map
CTSA	Core PD map
PPP3CB	Core PD map
RPS6KA3	Core PD map
NDUFAF2	Core PD map
SOD1	Core PD map
ADCY6	Core PD map
UQCR11	Core PD map
GRIN1	Core PD map
TOMM22	Core PD map
DDIT4	Core PD map
ANPEP	Core PD map
NCOR2	Core PD map
SLC7A11	Core PD map
ITPR2	Core PD map
TIMM17A	Core PD map
NDN	Core PD map
PITX3	Core PD map
SDHC	Core PD map
TOMM6	Core PD map
HSPE1	Core PD map
GABARAPL2	Core PD map
MAPT	Core PD map
ATP6V1B2	Core PD map
MYO6	Core PD map
RAB7B	Core PD map
MAP1LC3B	Core PD map
TYR	Core PD map
PPP3R1	Core PD map
LRRK2	Core PD map
ULK1	Core PD map
SNX1	Core PD map
SUCLG1	Core PD map
RNF139	Core PD map
PKLR	Core PD map
CAMK1	Core PD map
ITPR1	Core PD map
ERN2	Core PD map
STX1A	Core PD map
MT-TH	Core PD map
NDUFB2	Core PD map
DRD2	Core PD map
SNX5	Core PD map
RAB32	Core PD map
NUB1	Core PD map
UBE3A	Core PD map
MT-TE	Core PD map
PLK2	Core PD map
KIF5B	Core PD map
FOXA1	Core PD map
FYN	Core PD map
ADH1A	Core PD map
ATP6V1H	Core PD map
PTGS2	Core PD map
NDUFA6	Core PD map
NAF1	Core PD map
ROCK2	Actin filament organization
ACTR2	Actin filament organization
PFN1	Actin filament organization
PLEC	Actin filament organization
ACTR3	Actin filament organization
PFN2	Actin filament organization
CDC42	Actin filament organization
WAS	Actin filament organization
LRRK2	Actin filament organization
MSN	Actin filament organization
RAC1	Actin filament organization
PAK6	Actin filament organization
EZR	Actin filament organization
SSH1	Actin filament organization
WASF1	Actin filament organization
RDX	Actin filament organization
WASL	Actin filament organization
WASF3	Actin filament organization
LIMK2	Actin filament organization
CFL2	Actin filament organization
SSH3	Actin filament organization
CFL1	Actin filament organization
LIMK1	Actin filament organization
RHO	Actin filament organization
CASP8	Actin filament organization
CX3CL1	Neuroinflammation
PPP1R12A	Neuroinflammation
TRADD	Neuroinflammation
TREM2	Neuroinflammation
IL6	Neuroinflammation
GFAP	Neuroinflammation
CD36	Neuroinflammation
CYBB	Neuroinflammation
SOCS1	Neuroinflammation
JAK1	Neuroinflammation
AGER	Neuroinflammation
CXCL2	Neuroinflammation
IRF1	Neuroinflammation
TLR9	Neuroinflammation
MYD88	Neuroinflammation
TFEB	Neuroinflammation
NPC1	Neuroinflammation
CHUK	Neuroinflammation
SEMA3A	Neuroinflammation
FADD	Neuroinflammation
SLC1A3	Neuroinflammation
HMGB1	Neuroinflammation
CD200R1	Neuroinflammation
TLR3	Neuroinflammation
LAMP2	Neuroinflammation
ACE	Neuroinflammation
SLC1A2	Neuroinflammation
RELA	Neuroinflammation
CASP8	Neuroinflammation
NR3C1	Neuroinflammation
TRAF6	Neuroinflammation
SYK	Neuroinflammation
TFE3	Neuroinflammation
NFATC1	Neuroinflammation
CCL20	Neuroinflammation
NRP1	Neuroinflammation
PPARG	Neuroinflammation
C3	Neuroinflammation
SIRPA	Neuroinflammation
IL1B	Neuroinflammation
TNF	Neuroinflammation
SRC	Neuroinflammation
NRON	Neuroinflammation
AGTR2	Neuroinflammation
TLR4	Neuroinflammation
TAT	Neuroinflammation
HSPD1	Neuroinflammation
PLXNA1	Neuroinflammation
IFNGR2	Neuroinflammation
IL10	Neuroinflammation
CYBA	Neuroinflammation
APP	Neuroinflammation
ITGB2	Neuroinflammation
CD14	Neuroinflammation
CX3CR1	Neuroinflammation
MMP9	Neuroinflammation
HCAR2	Neuroinflammation
NCF2	Neuroinflammation
TLR1	Neuroinflammation
TLR2	Neuroinflammation
RHOA	Neuroinflammation
IFNGR1	Neuroinflammation
IL1R1	Neuroinflammation
TAC1	Neuroinflammation
IFNAR1	Neuroinflammation
MAPK14	Neuroinflammation
MAP3K7	Neuroinflammation
ADORA2A	Neuroinflammation
MAPK8	Neuroinflammation
FOXA2	Neuroinflammation
IL13	Neuroinflammation
NR4A1	Neuroinflammation
STAT3	Neuroinflammation
NOS2	Neuroinflammation
TICAM1	Neuroinflammation
IGF1R	Neuroinflammation
CXCL1	Neuroinflammation
IFNG	Neuroinflammation
NFKB1	Neuroinflammation
IKBKB	Neuroinflammation
TYROBP	Neuroinflammation
TNFRSF1A	Neuroinflammation
P2RX7	Neuroinflammation
HMOX1	Neuroinflammation
JAK2	Neuroinflammation
TRAF2	Neuroinflammation
NFE2L2	Neuroinflammation
PRKCD	Neuroinflammation
RAC2	Neuroinflammation
ARG1	Neuroinflammation
GDNF	Neuroinflammation
BDNF	Neuroinflammation
APOE	Neuroinflammation
IFNAR2	Neuroinflammation
TGFB1	Neuroinflammation
IL4	Neuroinflammation
EHMT2	Neuroinflammation
GLRX	Neuroinflammation
RAC1	Neuroinflammation
NLRP3	Neuroinflammation
MAPK7	Neuroinflammation
MAPK10	Neuroinflammation
ITGAM	Neuroinflammation
FAS	Neuroinflammation
C1QA	Neuroinflammation
NFATC2	Neuroinflammation
ROCK2	Neuroinflammation
AGTR1	Neuroinflammation
P2RY6	Neuroinflammation
GSK3B	Neuroinflammation
CD68	Neuroinflammation
ICAM1	Neuroinflammation
CCL2	Neuroinflammation
IL18	Neuroinflammation
SOD1	Neuroinflammation
CD22	Neuroinflammation
MPO	Neuroinflammation
SLC7A11	Neuroinflammation
NFATC3	Neuroinflammation
CD200	Neuroinflammation
VCAM1	Neuroinflammation
NCF4	Neuroinflammation
NGF	Neuroinflammation
MMP3	Neuroinflammation
IRF7	Neuroinflammation
CCL4	Neuroinflammation
PTPRC	Neuroinflammation
NR4A2	Neuroinflammation
FASLG	Neuroinflammation
LRRK2	Neuroinflammation
SOCS3	Neuroinflammation
CASP1	Neuroinflammation
MAPK9	Neuroinflammation
PTK2	Neuroinflammation
SNCA	Neuroinflammation
NTF3	Neuroinflammation
S100B	Neuroinflammation
CD47	Neuroinflammation
TFEC	Neuroinflammation
IRAK4	Neuroinflammation
NCF1	Neuroinflammation
DRD2	Neuroinflammation
MITF	Neuroinflammation
CCL3	Neuroinflammation
AGT	Neuroinflammation
FYN	Neuroinflammation
SHH	Neuroinflammation
RCOR1	Neuroinflammation
IGF1	Neuroinflammation
PTGS2	Neuroinflammation
RIPK1	Neuroinflammation
SRA1	Neuroinflammation
AGO2	PI3K AKT signaling
ROCK2	PI3K AKT signaling
GSK3B	PI3K AKT signaling
RET	PI3K AKT signaling
IGF1R	PI3K AKT signaling
PTEN	PI3K AKT signaling
EIF2A	PI3K AKT signaling
EIF2AK3	PI3K AKT signaling
MIRLET7A1	PI3K AKT signaling
AKT1	PI3K AKT signaling
RPS6KB1	PI3K AKT signaling
RPS15	PI3K AKT signaling
PRKCD	PI3K AKT signaling
INS	PI3K AKT signaling
TFDP1	PI3K AKT signaling
NGF	PI3K AKT signaling
GDNF	PI3K AKT signaling
DDIT3	PI3K AKT signaling
CCN4	PI3K AKT signaling
MCOLN1	PI3K AKT signaling
LRRK2	PI3K AKT signaling
TFEB	PI3K AKT signaling
PPP2CB	PI3K AKT signaling
SNCA	PI3K AKT signaling
PDPK1	PI3K AKT signaling
MIR184	PI3K AKT signaling
IDE	PI3K AKT signaling
MAPK14	PI3K AKT signaling
EIF4EBP1	PI3K AKT signaling
GFRA1	PI3K AKT signaling
NTRK1	PI3K AKT signaling
PPP2CA	PI3K AKT signaling
SLC38A9	PI3K AKT signaling
PHLPP1	PI3K AKT signaling
E2F1	PI3K AKT signaling
IGF1	PI3K AKT signaling
NEDD4	PI3K AKT signaling
INSR	PI3K AKT signaling
EIF4E	PI3K AKT signaling
IRS1	PI3K AKT signaling
MAPK1	PI3K AKT signaling
ADHFE1	Mitochondrial and ROS metabolism
UQCRFS1	Mitochondrial and ROS metabolism
NDUFB6	Mitochondrial and ROS metabolism
GPX6	Mitochondrial and ROS metabolism
ELOVL6	Mitochondrial and ROS metabolism
P4HB	Mitochondrial and ROS metabolism
NDUFB1	Mitochondrial and ROS metabolism
NDUFB8	Mitochondrial and ROS metabolism
MPC2	Mitochondrial and ROS metabolism
SUCLG2	Mitochondrial and ROS metabolism
GLUD1	Mitochondrial and ROS metabolism
ECI1	Mitochondrial and ROS metabolism
HMGCS2	Mitochondrial and ROS metabolism
GK	Mitochondrial and ROS metabolism
SOD2	Mitochondrial and ROS metabolism
NDUFB11	Mitochondrial and ROS metabolism
NDUFV3	Mitochondrial and ROS metabolism
PDHX	Mitochondrial and ROS metabolism
CYBB	Mitochondrial and ROS metabolism
COX5B	Mitochondrial and ROS metabolism
UQCRC1	Mitochondrial and ROS metabolism
UQCRC2	Mitochondrial and ROS metabolism
UQCRFS1P1	Mitochondrial and ROS metabolism
PTGES3	Mitochondrial and ROS metabolism
CAT	Mitochondrial and ROS metabolism
ATP5PD	Mitochondrial and ROS metabolism
HSD17B12	Mitochondrial and ROS metabolism
GSR	Mitochondrial and ROS metabolism
ATP5PB	Mitochondrial and ROS metabolism
GHITM	Mitochondrial and ROS metabolism
AGPAT4	Mitochondrial and ROS metabolism
UQCR10	Mitochondrial and ROS metabolism
COX7A2	Mitochondrial and ROS metabolism
NDUFA11	Mitochondrial and ROS metabolism
ELOVL3	Mitochondrial and ROS metabolism
DGAT2	Mitochondrial and ROS metabolism
COX7B	Mitochondrial and ROS metabolism
ATP5MF	Mitochondrial and ROS metabolism
PDK3	Mitochondrial and ROS metabolism
NDUFS6	Mitochondrial and ROS metabolism
SLC25A6	Mitochondrial and ROS metabolism
HMGCL	Mitochondrial and ROS metabolism
PARK7	Mitochondrial and ROS metabolism
NNT	Mitochondrial and ROS metabolism
GPX5	Mitochondrial and ROS metabolism
ECHS1	Mitochondrial and ROS metabolism
ATOX1	Mitochondrial and ROS metabolism
NDUFC2	Mitochondrial and ROS metabolism
NDUFA7	Mitochondrial and ROS metabolism
ELOVL7	Mitochondrial and ROS metabolism
NDUFA12	Mitochondrial and ROS metabolism
PTGES2	Mitochondrial and ROS metabolism
NOX5	Mitochondrial and ROS metabolism
CPT2	Mitochondrial and ROS metabolism
MT-ND1	Mitochondrial and ROS metabolism
CYCS	Mitochondrial and ROS metabolism
PDPR	Mitochondrial and ROS metabolism
PTGES	Mitochondrial and ROS metabolism
MT-CYB	Mitochondrial and ROS metabolism
DLAT	Mitochondrial and ROS metabolism
PINK1	Mitochondrial and ROS metabolism
MT-ND2	Mitochondrial and ROS metabolism
ACADL	Mitochondrial and ROS metabolism
NDUFA3	Mitochondrial and ROS metabolism
GPX4	Mitochondrial and ROS metabolism
MPC1	Mitochondrial and ROS metabolism
NDUFS3	Mitochondrial and ROS metabolism
ABHD5	Mitochondrial and ROS metabolism
SLC25A1	Mitochondrial and ROS metabolism
UQCRQ	Mitochondrial and ROS metabolism
TECR	Mitochondrial and ROS metabolism
ACSS1	Mitochondrial and ROS metabolism
ACLY	Mitochondrial and ROS metabolism
IDH2	Mitochondrial and ROS metabolism
MT-CO2	Mitochondrial and ROS metabolism
SDHD	Mitochondrial and ROS metabolism
MCEE	Mitochondrial and ROS metabolism
MT-ATP8	Mitochondrial and ROS metabolism
PRDX1	Mitochondrial and ROS metabolism
ACADM	Mitochondrial and ROS metabolism
CHCHD2	Mitochondrial and ROS metabolism
L2HGDH	Mitochondrial and ROS metabolism
ATP5ME	Mitochondrial and ROS metabolism
ACSL3	Mitochondrial and ROS metabolism
ATP5F1D	Mitochondrial and ROS metabolism
ACSL4	Mitochondrial and ROS metabolism
NDUFB7	Mitochondrial and ROS metabolism
NDUFS8	Mitochondrial and ROS metabolism
ACACA	Mitochondrial and ROS metabolism
CYBA	Mitochondrial and ROS metabolism
NDUFA9	Mitochondrial and ROS metabolism
UQCRB	Mitochondrial and ROS metabolism
OXCT1	Mitochondrial and ROS metabolism
NDUFA8	Mitochondrial and ROS metabolism
AGPAT3	Mitochondrial and ROS metabolism
MT-ND4L	Mitochondrial and ROS metabolism
NCF2	Mitochondrial and ROS metabolism
DBT	Mitochondrial and ROS metabolism
SLC25A10	Mitochondrial and ROS metabolism
NDUFS1	Mitochondrial and ROS metabolism
TXNRD2	Mitochondrial and ROS metabolism
COX7A1	Mitochondrial and ROS metabolism
GPAM	Mitochondrial and ROS metabolism
NDUFV2	Mitochondrial and ROS metabolism
SIRT3	Mitochondrial and ROS metabolism
IDH3B	Mitochondrial and ROS metabolism
ACO2	Mitochondrial and ROS metabolism
ELOVL4	Mitochondrial and ROS metabolism
COX6A2	Mitochondrial and ROS metabolism
NDUFA13	Mitochondrial and ROS metabolism
AGPAT2	Mitochondrial and ROS metabolism
HADH	Mitochondrial and ROS metabolism
AKR1C3	Mitochondrial and ROS metabolism
NDUFB10	Mitochondrial and ROS metabolism
PRDX6	Mitochondrial and ROS metabolism
MDH2	Mitochondrial and ROS metabolism
NDUFB9	Mitochondrial and ROS metabolism
GPX2	Mitochondrial and ROS metabolism
LPIN3	Mitochondrial and ROS metabolism
NDUFAB1	Mitochondrial and ROS metabolism
NDUFS4	Mitochondrial and ROS metabolism
MT-ND6	Mitochondrial and ROS metabolism
GPAT3	Mitochondrial and ROS metabolism
FASN	Mitochondrial and ROS metabolism
MT-ND4	Mitochondrial and ROS metabolism
IDH3A	Mitochondrial and ROS metabolism
ATP5F1A	Mitochondrial and ROS metabolism
NDUFS2	Mitochondrial and ROS metabolism
ACAT1	Mitochondrial and ROS metabolism
FH	Mitochondrial and ROS metabolism
DGAT1	Mitochondrial and ROS metabolism
ATP5F1EP2	Mitochondrial and ROS metabolism
UQCRH	Mitochondrial and ROS metabolism
PDP2	Mitochondrial and ROS metabolism
GPX8	Mitochondrial and ROS metabolism
PDK4	Mitochondrial and ROS metabolism
MT-ND5	Mitochondrial and ROS metabolism
CPT1B	Mitochondrial and ROS metabolism
MBOAT2	Mitochondrial and ROS metabolism
LPIN1	Mitochondrial and ROS metabolism
SDHB	Mitochondrial and ROS metabolism
PDHA1	Mitochondrial and ROS metabolism
SIRT5	Mitochondrial and ROS metabolism
ATP5MC3	Mitochondrial and ROS metabolism
NDUFA1	Mitochondrial and ROS metabolism
NUDT2	Mitochondrial and ROS metabolism
GPX3	Mitochondrial and ROS metabolism
OGDH	Mitochondrial and ROS metabolism
COX7C	Mitochondrial and ROS metabolism
ATP5MG	Mitochondrial and ROS metabolism
PRDX2	Mitochondrial and ROS metabolism
COX6A1	Mitochondrial and ROS metabolism
ACADVL	Mitochondrial and ROS metabolism
COX4I1	Mitochondrial and ROS metabolism
MMAA	Mitochondrial and ROS metabolism
LPIN2	Mitochondrial and ROS metabolism
ATP5MC2	Mitochondrial and ROS metabolism
CPT1A	Mitochondrial and ROS metabolism
GPX7	Mitochondrial and ROS metabolism
SLC25A4	Mitochondrial and ROS metabolism
HADHA	Mitochondrial and ROS metabolism
NDUFA10	Mitochondrial and ROS metabolism
GPAT2	Mitochondrial and ROS metabolism
D2HGDH	Mitochondrial and ROS metabolism
MBOAT1	Mitochondrial and ROS metabolism
CCS	Mitochondrial and ROS metabolism
SUCLA2	Mitochondrial and ROS metabolism
SLC25A12	Mitochondrial and ROS metabolism
ATP5F1C	Mitochondrial and ROS metabolism
IDH3G	Mitochondrial and ROS metabolism
SLC25A23	Mitochondrial and ROS metabolism
TXN	Mitochondrial and ROS metabolism
ATP5PF	Mitochondrial and ROS metabolism
PRDX5	Mitochondrial and ROS metabolism
ATP5IF1	Mitochondrial and ROS metabolism
ATP7A	Mitochondrial and ROS metabolism
ELOVL5	Mitochondrial and ROS metabolism
COX4I2	Mitochondrial and ROS metabolism
COX8A	Mitochondrial and ROS metabolism
SLC25A5	Mitochondrial and ROS metabolism
ATP5F1E	Mitochondrial and ROS metabolism
GPX1	Mitochondrial and ROS metabolism
ACACB	Mitochondrial and ROS metabolism
NDUFA4	Mitochondrial and ROS metabolism
PTGDS	Mitochondrial and ROS metabolism
PDK1	Mitochondrial and ROS metabolism
HADHB	Mitochondrial and ROS metabolism
NDUFS5	Mitochondrial and ROS metabolism
DLD	Mitochondrial and ROS metabolism
AGPAT1	Mitochondrial and ROS metabolism
NDUFB5	Mitochondrial and ROS metabolism
PDK2	Mitochondrial and ROS metabolism
DECR1	Mitochondrial and ROS metabolism
ACSL6	Mitochondrial and ROS metabolism
COX7A2L	Mitochondrial and ROS metabolism
NDUFC1	Mitochondrial and ROS metabolism
ERO1A	Mitochondrial and ROS metabolism
COX5A	Mitochondrial and ROS metabolism
PTGS1	Mitochondrial and ROS metabolism
MT-CO1	Mitochondrial and ROS metabolism
NDUFB3	Mitochondrial and ROS metabolism
MT-ATP6	Mitochondrial and ROS metabolism
AQP8	Mitochondrial and ROS metabolism
ACSL5	Mitochondrial and ROS metabolism
PCCB	Mitochondrial and ROS metabolism
ACADS	Mitochondrial and ROS metabolism
SOD1	Mitochondrial and ROS metabolism
UQCR11	Mitochondrial and ROS metabolism
NOX4	Mitochondrial and ROS metabolism
ATP5PO	Mitochondrial and ROS metabolism
ATP5MC1	Mitochondrial and ROS metabolism
ATP5F1B	Mitochondrial and ROS metabolism
PC	Mitochondrial and ROS metabolism
GPD1	Mitochondrial and ROS metabolism
NDUFA5	Mitochondrial and ROS metabolism
NDUFB4	Mitochondrial and ROS metabolism
SDHC	Mitochondrial and ROS metabolism
PDHB	Mitochondrial and ROS metabolism
LCLAT1	Mitochondrial and ROS metabolism
SOD3	Mitochondrial and ROS metabolism
NCF4	Mitochondrial and ROS metabolism
GPD2	Mitochondrial and ROS metabolism
GPAT4	Mitochondrial and ROS metabolism
BCS1L	Mitochondrial and ROS metabolism
MT-CO3	Mitochondrial and ROS metabolism
SLC25A11	Mitochondrial and ROS metabolism
NDUFA2	Mitochondrial and ROS metabolism
MT-ND3	Mitochondrial and ROS metabolism
ATP5MGL	Mitochondrial and ROS metabolism
NDUFS7	Mitochondrial and ROS metabolism
SUCLG1	Mitochondrial and ROS metabolism
PDP1	Mitochondrial and ROS metabolism
SNCA	Mitochondrial and ROS metabolism
NDUFB2	Mitochondrial and ROS metabolism
NCF1	Mitochondrial and ROS metabolism
NDUFV1	Mitochondrial and ROS metabolism
GSTP1	Mitochondrial and ROS metabolism
SLC25A20	Mitochondrial and ROS metabolism
ACSL1	Mitochondrial and ROS metabolism
TXNRD1	Mitochondrial and ROS metabolism
NDUFAF1	Mitochondrial and ROS metabolism
CS	Mitochondrial and ROS metabolism
SDHA	Mitochondrial and ROS metabolism
BDH1	Mitochondrial and ROS metabolism
PTGS2	Mitochondrial and ROS metabolism
NDUFA6	Mitochondrial and ROS metabolism
ALDH2	Mitochondrial and ROS metabolism
PCCA	Mitochondrial and ROS metabolism
GSK3B	Wnt signaling
LRRK2	Wnt signaling
APC	Wnt signaling
WNT3	Wnt signaling
WNT1	Wnt signaling
LRP5	Wnt signaling
CTNNB1	Wnt signaling
PIN1	Wnt signaling
FZD1	Wnt signaling
PRKN	Wnt signaling
GDNF	Wnt signaling
TGFB1	Wnt signaling
GRM3	Wnt signaling
LRP6	Wnt signaling
ROCK2	Axonal remodeling and CDK5 signaling
ACTR2	Axonal remodeling and CDK5 signaling
PFN1	Axonal remodeling and CDK5 signaling
CTNND2	Axonal remodeling and CDK5 signaling
PLEC	Axonal remodeling and CDK5 signaling
MAG	Axonal remodeling and CDK5 signaling
MIR133B	Axonal remodeling and CDK5 signaling
CAPNS1	Axonal remodeling and CDK5 signaling
MEF2D	Axonal remodeling and CDK5 signaling
CDK5R1	Axonal remodeling and CDK5 signaling
OMG	Axonal remodeling and CDK5 signaling
PRDX2	Axonal remodeling and CDK5 signaling
ACTR3	Axonal remodeling and CDK5 signaling
PFN2	Axonal remodeling and CDK5 signaling
PRKN	Axonal remodeling and CDK5 signaling
PLXNA1	Axonal remodeling and CDK5 signaling
CDC42	Axonal remodeling and CDK5 signaling
WAS	Axonal remodeling and CDK5 signaling
RTN4	Axonal remodeling and CDK5 signaling
LRRK2	Axonal remodeling and CDK5 signaling
MSN	Axonal remodeling and CDK5 signaling
RAC1	Axonal remodeling and CDK5 signaling
PAK6	Axonal remodeling and CDK5 signaling
SNCA	Axonal remodeling and CDK5 signaling
SEMA3A	Axonal remodeling and CDK5 signaling
EZR	Axonal remodeling and CDK5 signaling
SSH1	Axonal remodeling and CDK5 signaling
WASF1	Axonal remodeling and CDK5 signaling
NGFR	Axonal remodeling and CDK5 signaling
RHOA	Axonal remodeling and CDK5 signaling
CDK5	Axonal remodeling and CDK5 signaling
RDX	Axonal remodeling and CDK5 signaling
WASL	Axonal remodeling and CDK5 signaling
GSTP1	Axonal remodeling and CDK5 signaling
LINGO1	Axonal remodeling and CDK5 signaling
WASF3	Axonal remodeling and CDK5 signaling
LIMK2	Axonal remodeling and CDK5 signaling
CFL2	Axonal remodeling and CDK5 signaling
CAPN1	Axonal remodeling and CDK5 signaling
SSH3	Axonal remodeling and CDK5 signaling
RTN4R	Axonal remodeling and CDK5 signaling
CFL1	Axonal remodeling and CDK5 signaling
PIN1	Axonal remodeling and CDK5 signaling
LIMK1	Axonal remodeling and CDK5 signaling
RHO	Axonal remodeling and CDK5 signaling
CASP8	Axonal remodeling and CDK5 signaling
HTRA2	FOXO3 activity
TFAM	FOXO3 activity
RICTOR	FOXO3 activity
TXNIP	FOXO3 activity
MAP1LC3A	FOXO3 activity
FIS1	FOXO3 activity
SOD2	FOXO3 activity
AKT1	FOXO3 activity
BECN1	FOXO3 activity
MFN2	FOXO3 activity
CAT	FOXO3 activity
CEBPB	FOXO3 activity
HSPE1	FOXO3 activity
SIRT2	FOXO3 activity
FOXO3	FOXO3 activity
HSPD1	FOXO3 activity
DDIT3	FOXO3 activity
MUL1	FOXO3 activity
FASLG	FOXO3 activity
BBC3	FOXO3 activity
DNM1L	FOXO3 activity
MAPK9	FOXO3 activity
SESN3	FOXO3 activity
SNCA	FOXO3 activity
CLPP	FOXO3 activity
LONP1	FOXO3 activity
MAPK14	FOXO3 activity
EIF4EBP1	FOXO3 activity
GPX1	FOXO3 activity
SIRT3	FOXO3 activity
MAP3K5	FOXO3 activity
JUN	FOXO3 activity
BNIP3L	FOXO3 activity
BCL2L11	FOXO3 activity
PPARGC1A	FOXO3 activity
BNIP3	FOXO3 activity
MAPK8	FOXO3 activity
SIRT1	FOXO3 activity
GABARAPL1	FOXO3 activity
CASP8	FOXO3 activity
ATG12	FOXO3 activity
PINK1	FOXO3 activity
ATG101	Autophagy
BECN1	Autophagy
EXOC4	Autophagy
EXOC2	Autophagy
EXOC8	Autophagy
ATG13	Autophagy
EXOC5	Autophagy
EXOC7	Autophagy
ULK1	Autophagy
EXOC1	Autophagy
ATG14	Autophagy
EXOC3	Autophagy
RB1CC1	Autophagy
PIK3R4	Autophagy
PIK3C3	Autophagy
EXOC6	Autophagy
RALB	Autophagy
FASN	PRKN substrates
ATP5F1A	PRKN substrates
ATAD1	PRKN substrates
GPR37	PRKN substrates
SQSTM1	PRKN substrates
SLC6A3	PRKN substrates
CISD1	PRKN substrates
DDIT4	PRKN substrates
ATP5F1B	PRKN substrates
AIMP2	PRKN substrates
UQCRC2	PRKN substrates
PTRH2	PRKN substrates
PHB2	PRKN substrates
ATP5PB	PRKN substrates
GHITM	PRKN substrates
PRKN	PRKN substrates
SSBP1	PRKN substrates
NDUFS8	PRKN substrates
CPT1A	PRKN substrates
ACSL4	PRKN substrates
HADHA	PRKN substrates
PMPCA	PRKN substrates
HSDL1	PRKN substrates
CCNE2	PRKN substrates
SYT11	PRKN substrates
SNCAIP	PRKN substrates
HK1	PRKN substrates
CCNE1	PRKN substrates
SLC25A5	PRKN substrates
NME2	PRKN substrates
NDUFA4	PRKN substrates
FUBP1	PRKN substrates
YWHAG	LRRK2 activity
PRDX3	LRRK2 activity
CSNK1A1	LRRK2 activity
YWHAQ	LRRK2 activity
TAOK3	LRRK2 activity
YWHAZ	LRRK2 activity
STK3	LRRK2 activity
PPP1CA	LRRK2 activity
STK25	LRRK2 activity
RAB29	LRRK2 activity
LRRK2	LRRK2 activity
ARHGEF7	LRRK2 activity
RAC1	LRRK2 activity
STK24	LRRK2 activity
FOXO1	LRRK2 activity
MAPK14	LRRK2 activity
PPP1CC	LRRK2 activity
STUB1	LRRK2 activity
YWHAE	LRRK2 activity
PPP1CB	LRRK2 activity
TP53	LRRK2 activity
PSMC1	Ubiquitin-proteasome system
PSMA1	Ubiquitin-proteasome system
PSMB6	Ubiquitin-proteasome system
PSMD4	Ubiquitin-proteasome system
PSMA7	Ubiquitin-proteasome system
PSMB1	Ubiquitin-proteasome system
PSMD8	Ubiquitin-proteasome system
PSMD14	Ubiquitin-proteasome system
PSMC3	Ubiquitin-proteasome system
PSMD6	Ubiquitin-proteasome system
RAD23B	Ubiquitin-proteasome system
PSMD9	Ubiquitin-proteasome system
PSMD11	Ubiquitin-proteasome system
PSMB5	Ubiquitin-proteasome system
PSMB4	Ubiquitin-proteasome system
PSMD2	Ubiquitin-proteasome system
PSMC4	Ubiquitin-proteasome system
PSMA2	Ubiquitin-proteasome system
PSMD1	Ubiquitin-proteasome system
PSMA5	Ubiquitin-proteasome system
PSMB2	Ubiquitin-proteasome system
PSMB7	Ubiquitin-proteasome system
PSMD3	Ubiquitin-proteasome system
PSMC2	Ubiquitin-proteasome system
ST13	Ubiquitin-proteasome system
HSPA4	Ubiquitin-proteasome system
PSMD12	Ubiquitin-proteasome system
PSMC6	Ubiquitin-proteasome system
PSMA6	Ubiquitin-proteasome system
UBA1	Ubiquitin-proteasome system
PSMB3	Ubiquitin-proteasome system
PSMA3	Ubiquitin-proteasome system
UBA6	Ubiquitin-proteasome system
RAD23A	Ubiquitin-proteasome system
PSMD7	Ubiquitin-proteasome system
ADRM1	Ubiquitin-proteasome system
PSMC5	Ubiquitin-proteasome system
PSMA4	Ubiquitin-proteasome system
FTL	Iron metabolism
STEAP2	Iron metabolism
ACO1	Iron metabolism
NOS2	Iron metabolism
TRPC1	Iron metabolism
HEPH	Iron metabolism
SLC25A37	Iron metabolism
NDFIP1	Iron metabolism
NEDD4L	Iron metabolism
SOD1	Iron metabolism
STEAP1	Iron metabolism
FTH1	Iron metabolism
STEAP3	Iron metabolism
FXN	Iron metabolism
SOD2	Iron metabolism
LTF	Iron metabolism
HMOX1	Iron metabolism
ITLN1	Iron metabolism
RAB7A	Iron metabolism
TFR2	Iron metabolism
CAT	Iron metabolism
MAPT	Iron metabolism
AGER	Iron metabolism
PRKN	Iron metabolism
SLC40A1	Iron metabolism
MCOLN1	Iron metabolism
TF	Iron metabolism
CP	Iron metabolism
PANK2	Iron metabolism
LRRK2	Iron metabolism
APP	Iron metabolism
ITGB2	Iron metabolism
BLVRA	Iron metabolism
SCARA5	Iron metabolism
DNM1L	Iron metabolism
VPS35	Iron metabolism
ATP13A2	Iron metabolism
SLC11A2	Iron metabolism
ITGAM	Iron metabolism
COASY	Iron metabolism
C1QA	Iron metabolism
IREB2	Iron metabolism
PLA2G6	Iron metabolism
FTMT	Iron metabolism
TRPC6	Iron metabolism
TFRC	Iron metabolism
SLC25A28	Iron metabolism
RAB5A	Iron metabolism
HAMP	Iron metabolism
PIDD1	Cell death
GSK3B	Cell death
HTRA2	Cell death
MAP2K4	Cell death
MAP2K7	Cell death
NMT1	Cell death
SFN	Cell death
GSN	Cell death
AKT1	Cell death
YWHAZ	Cell death
GZMB	Cell death
PRKCD	Cell death
BCL2L1	Cell death
CASP6	Cell death
BAK1	Cell death
CASP2	Cell death
GAS2	Cell death
CASP7	Cell death
TRIM17	Cell death
XRCC6	Cell death
CHCHD2	Cell death
PRKN	Cell death
MCL1	Cell death
CASP9	Cell death
PPP3R1	Cell death
SLC25A4	Cell death
XIAP	Cell death
BBC3	Cell death
CRADD	Cell death
ATG5	Cell death
DBNL	Cell death
MAPK9	Cell death
CASP3	Cell death
CTNNB1	Cell death
HK2	Cell death
NEK1	Cell death
APAF1	Cell death
PARK7	Cell death
NDRG1	Cell death
BID	Cell death
MAPK10	Cell death
BCL2	Cell death
VDAC1	Cell death
ADD1	Cell death
MAPK8IP3	Cell death
VDAC2	Cell death
FBXW7	Cell death
CAPN2	Cell death
BAD	Cell death
SIRT3	Cell death
PPP3CC	Cell death
VIM	Cell death
CAPN1	Cell death
CYCS	Cell death
BCL2L11	Cell death
PIN1	Cell death
DIABLO	Cell death
MAPK8	Cell death
BAX	Cell death
TRAP1	Cell death
VDAC3	Cell death
BMF	Cell death
CASP8	Cell death
ATG12	Cell death
PPIF	Cell death
PMAIP1	Cell death
PINK1	Cell death
MAPK1	Cell death
SESN2	MTOR AMPK signaling
GSK3B	MTOR AMPK signaling
PRKAA2	MTOR AMPK signaling
RPTOR	MTOR AMPK signaling
DEPTOR	MTOR AMPK signaling
DEPDC5	MTOR AMPK signaling
RICTOR	MTOR AMPK signaling
NPRL2	MTOR AMPK signaling
NPRL3	MTOR AMPK signaling
PRKAB1	MTOR AMPK signaling
CALM1	MTOR AMPK signaling
AKT1S1	MTOR AMPK signaling
AKT1	MTOR AMPK signaling
DDIT4	MTOR AMPK signaling
PRKAA1	MTOR AMPK signaling
RPS6KB1	MTOR AMPK signaling
GHRL	MTOR AMPK signaling
DDB1	MTOR AMPK signaling
PRKAG3	MTOR AMPK signaling
UCHL1	MTOR AMPK signaling
RRAGA	MTOR AMPK signaling
RHEB	MTOR AMPK signaling
PRR5	MTOR AMPK signaling
LAMTOR1	MTOR AMPK signaling
PRKN	MTOR AMPK signaling
MTOR	MTOR AMPK signaling
STK11	MTOR AMPK signaling
LAMTOR2	MTOR AMPK signaling
CUL4A	MTOR AMPK signaling
CAMKK2	MTOR AMPK signaling
RRAGD	MTOR AMPK signaling
PRKAG2	MTOR AMPK signaling
UBE2N	MTOR AMPK signaling
RRAGC	MTOR AMPK signaling
LAMTOR3	MTOR AMPK signaling
MAPKAP1	MTOR AMPK signaling
PARP1	MTOR AMPK signaling
TSC2	MTOR AMPK signaling
MLST8	MTOR AMPK signaling
SLC38A9	MTOR AMPK signaling
RRAGB	MTOR AMPK signaling
UBE2V1	MTOR AMPK signaling
TSC1	MTOR AMPK signaling
PHLPP1	MTOR AMPK signaling
NAMPT	MTOR AMPK signaling
SIRT1	MTOR AMPK signaling
NMRK1	MTOR AMPK signaling
PRKAG1	MTOR AMPK signaling
MAPK1	MTOR AMPK signaling
PRKAB2	MTOR AMPK signaling
NFKBIA	Inflammation signaling
NFKB1	Inflammation signaling
MAP2K4	Inflammation signaling
TRADD	Inflammation signaling
IKBKB	Inflammation signaling
IL1B	Inflammation signaling
MAP2K7	Inflammation signaling
TNF	Inflammation signaling
TNFRSF1A	Inflammation signaling
TRAF2	Inflammation signaling
BTRC	Inflammation signaling
PPP5C	Inflammation signaling
IKBKG	Inflammation signaling
MAP2K3	Inflammation signaling
MYD88	Inflammation signaling
RELA	Inflammation signaling
MAP2K6	Inflammation signaling
CHUK	Inflammation signaling
MAPK9	Inflammation signaling
TXN	Inflammation signaling
PARK7	Inflammation signaling
IRAK4	Inflammation signaling
MAPK10	Inflammation signaling
IL1R1	Inflammation signaling
MAPK14	Inflammation signaling
GSTP1	Inflammation signaling
MAP3K5	Inflammation signaling
MAP3K7	Inflammation signaling
MAPK8	Inflammation signaling
PTGS2	Inflammation signaling
DAXX	Inflammation signaling
RIPK1	Inflammation signaling
TRAF6	Inflammation signaling
PINK1	Inflammation signaling
BPGM	Glycolysis
LDHA	Glycolysis
PGLS	Glycolysis
MPC2	Glycolysis
LDHB	Glycolysis
MPC1	Glycolysis
GCK	Glycolysis
GALM	Glycolysis
PGD	Glycolysis
CDK5R1	Glycolysis
ALDOA	Glycolysis
SKP2	Glycolysis
TPI1	Glycolysis
GAPDH	Glycolysis
CDH1	Glycolysis
FBP1	Glycolysis
PGAM4	Glycolysis
PGK1	Glycolysis
PFKL	Glycolysis
SLC16A7	Glycolysis
PFKP	Glycolysis
PKLR	Glycolysis
PGM1	Glycolysis
HK1	Glycolysis
CDK5	Glycolysis
CDK1	Glycolysis
SLC2A1	Glycolysis
CDK2	Glycolysis
ENO1	Glycolysis
SLC16A4	Glycolysis
CDKN1B	Glycolysis
CCNB1	Glycolysis
PFKM	Glycolysis
G6PD	Glycolysis
GPI	Glycolysis
G6PC	Glycolysis
SLC16A1	Glycolysis
PFKFB3	Glycolysis
NOS2	SHH signaling
EPO	SHH signaling
RET	SHH signaling
CD68	SHH signaling
NTRK2	SHH signaling
IL1B	SHH signaling
IL6	SHH signaling
TNF	SHH signaling
GFAP	SHH signaling
PTCH1	SHH signaling
PRKAA1	SHH signaling
GLI1	SHH signaling
GDNF	SHH signaling
BDNF	SHH signaling
TGFB1	SHH signaling
NR4A2	SHH signaling
CREB1	SHH signaling
MAP2	SHH signaling
S100B	SHH signaling
NES	SHH signaling
TUBB3	SHH signaling
ITGAM	SHH signaling
TH	SHH signaling
GFRA1	SHH signaling
PTGES2	SHH signaling
SHH	SHH signaling
SLC1A2	SHH signaling
SMO	SHH signaling
TH	Nicotine signaling
GSK3B	Nicotine signaling
CNR1	Nicotine signaling
NFE2L2	Nicotine signaling
CHRNA7	Nicotine signaling
WNT1	Nicotine signaling
GRM4	Nicotine signaling
KMO	Nicotine signaling
CTNNB1	Nicotine signaling
TNF	Nicotine signaling
BAX	Nicotine signaling
HMOX1	Nicotine signaling
GDNF	Nicotine signaling
DRD2	Nicotine signaling
BCL2	Nicotine signaling
HRH4	Nicotine signaling
CASP9	Nicotine signaling
HRH3	Histamine signaling
HDC	Histamine signaling
PTGES2	Histamine signaling
DRD1	Histamine signaling
IL1B	Histamine signaling
IL6	Histamine signaling
TNF	Histamine signaling
ITGA5	Histamine signaling
ITGB1	Histamine signaling
NOX1	Histamine signaling
HRH1	Histamine signaling
HRH4	Histamine signaling
NRP2	NR2F1 signaling
MC4R	NR2F1 signaling
ETV5	NR2F1 signaling
MC2R	NR2F1 signaling
SP8	NR2F1 signaling
NRP1	NR2F1 signaling
ZBTB20	NR2F1 signaling
CNR1	NR2F1 signaling
LHX2	NR2F1 signaling
SST	NR2F1 signaling
FABP7	NR2F1 signaling
MC1R	NR2F1 signaling
TBR1	NR2F1 signaling
IL1B	NR2F1 signaling
CALB1	NR2F1 signaling
BCL11B	NR2F1 signaling
TNF	NR2F1 signaling
PBX1	NR2F1 signaling
NOS1	NR2F1 signaling
MEST	NR2F1 signaling
FEZF2	NR2F1 signaling
NR5A1	NR2F1 signaling
INS	NR2F1 signaling
MC3R	NR2F1 signaling
PROX1	NR2F1 signaling
RND2	NR2F1 signaling
ACTN2	NR2F1 signaling
BDNF	NR2F1 signaling
LHX6	NR2F1 signaling
EGR2	NR2F1 signaling
FGFR3	NR2F1 signaling
GAD2	NR2F1 signaling
ETV4	NR2F1 signaling
HTR3A	NR2F1 signaling
NKX2-1	NR2F1 signaling
MBP	NR2F1 signaling
GCG	NR2F1 signaling
SPRY1	NR2F1 signaling
NR2F1	NR2F1 signaling
CALB2	NR2F1 signaling
ETV1	NR2F1 signaling
PAX6	NR2F1 signaling
NPY	NR2F1 signaling
CXCR4	NR2F1 signaling
TAC3	NR2F1 signaling
IL1A	NR2F1 signaling
GAD1	NR2F1 signaling
CCK	NR2F1 signaling
AXIN2	NR2F1 signaling
SPRY2	NR2F1 signaling
FGF8	NR2F1 signaling
VIP	NR2F1 signaling
RELN	NR2F1 signaling
MC5R	NR2F1 signaling
PENK	NR2F1 signaling
MKI67	NR2F1 signaling
FOXP2	NR2F1 signaling
NR2F2	NR2F1 signaling
NDRG1	NR2F1 signaling
GABRA1	NR2F1 signaling
POMC	NR2F1 signaling
MAPK3	NR2F1 signaling
MAPK1	NR2F1 signaling
NOS2	SRR signaling
DAO	SRR signaling
EPHB3	SRR signaling
PSAT1	SRR signaling
IL1B	SRR signaling
GLUD1	SRR signaling
SYP	SRR signaling
EFNB3	SRR signaling
PHGDH	SRR signaling
SLC17A6	SRR signaling
SLC1A4	SRR signaling
FOS	SRR signaling
CYBB	SRR signaling
CHI3L1	SRR signaling
SLC7A11	SRR signaling
MAPT	SRR signaling
FBXO22	SRR signaling
NOS3	SRR signaling
SLC7A10	SRR signaling
ARG1	SRR signaling
LMNA	SRR signaling
APOE	SRR signaling
TGFB1	SRR signaling
GAPDH	SRR signaling
GLUD2	SRR signaling
IL4	SRR signaling
NOX1	SRR signaling
PSPH	SRR signaling
PICK1	SRR signaling
JUNB	SRR signaling
APP	SRR signaling
SDS	SRR signaling
KDM4A	SRR signaling
SLC17A7	SRR signaling
MAPK9	SRR signaling
CASP3	SRR signaling
NCF2	SRR signaling
VAMP2	SRR signaling
MAPK10	SRR signaling
SLC1A3	SRR signaling
SRR	SRR signaling
NCF1	SRR signaling
BCL2	SRR signaling
CYCS	SRR signaling
PRKCA	SRR signaling
EPHA4	SRR signaling
MAPK8	SRR signaling
BAX	SRR signaling
